4 4
3 0 1 1 0 0 
3 1 1 0 1 0 
3 2 1 0 1 0 
3 3 1 0 0 1
2 0 0 1 0 0
2 1 1 0 0 0
2 2 1 0 0 1
2 3 0 1 0 1
1 0 0 1 1 0
1 1 0 0 1 0
1 2 0 0 1 1
1 3 0 1 0 1
0 0 1 1 1 0
0 1 1 0 1 0
0 2 1 0 1 0
0 3 0 0 1 1
START
1
1 0 u
GOAL
4  
3 0 u
3 0 d
3 0 l
3 0 r
4
