4 4
3 0 1 1 0 0
3 1 1 0 0 1
3 2 1 1 0 1
3 3 1 1 0 1
2 0 0 1 0 1
2 1 0 1 0 1
2 2 0 1 0 1
2 3 0 1 0 1
1 0 0 1 1 0
1 1 0 0 1 0
1 2 0 0 0 1
1 3 0 1 0 1
0 0 1 1 1 0
0 1 1 0 1 0
0 2 0 0 1 0
0 3 0 0 1 1 
START
1
0 1 l
GOAL
4
3 3 d
3 3 u
3 3 l
3 3 r
30