4 4
0 0 0 1 1 0
1 0 0 1 0 1
2 0 0 1 0 1
3 0 1 1 0 1
0 1 0 0 1 1
1 1 0 1 0 1
2 1 0 1 0 0
3 1 1 1 0 0
0 2 0 1 1 0
1 2 0 1 0 1
2 2 1 0 0 0
3 2 1 0 1 0
0 3 0 0 1 1
1 3 0 1 0 1
2 3 1 0 0 1
3 3 1 0 1 1
START
8
0 0 r
0 0 u
0 0 l
3 3 d
3 3 u
3 3 r
1 3 u
1 3 l
GOAL
4
0 3 d
0 3 u
0 3 l
0 3 r
30